type octile
height 25
width 25
map
TTTTTTTTTTTTTTTTTTTTTTTTT
TCCCCCCCSCCCCCCCSCCCCCCCT
TCBBBBBBCCCCSCCCCBBBBBBCT
TCBBBBBBCCCCCCCCCBBBBBBCT
TCCCCCCCCCTTTTTCCCCCCCCCT
TCCCCCCCCCCCCCCCCCCCCCCCT
TTTTTTCCCCCCCCCCCCCCTTTTT
TCCCCCCCCCAAAAACCCCCCCCCT
TCCCCCCCCCAAAAACCCCCCCCCT
TCCCCCCCCCAAAAACCCCCCCCCT
TCCCCCCCCCAAAAACCCCCCCCCT
TCCCCCCCCCAAAAACCCCCCCCCT
TCCCCCCCCCAAAAACCCCCCCCCT
TCCCCCCCCCAAAAACCCCCCCCCT
TCCCCCCCCCAAAAACCCCCCCCCT
TCCCCCCCCCAAAAACCCCCCCCCT
TCCCCCCCCCAAAAACCCCCCCCCT
TCCCCCCCCCAAAAACCCCCCCCCT
TTTTTTCCCCCCCCCCCCCCTTTTT
TCCCCCCCCCCCCCCCCCCCCCCCT
TCCCCCCCCCTTTTTCCCCCCCCCT
TCBBBBBBCCCCCCCCCBBBBBBCT
TCBBBBBBCCCCSCCCCBBBBBBCT
TCCCCCCCSCCCCCCCSCCCCCCCT
TTTTTTTTTTTTTTTTTTTTTTTTT