type octile
height 25
width 25
map
TTTTTTTTTTTTTTTTTTTTTTTTT
TCCCCCCCCCCCCCCCCCCCCCCCT
TCCCCCCCCCCCCCCCCCCCCCCCT
TCCCCCCCCCCCCCCCCCCCCCCCT
TCCCCCCCCCTTTTTCCCCCCCCCT
TCCCCCCCCCCCCCCCCCCCCCCCT
TTTTTTCCCCCCCCCCCCCCTTTTT
TCCCCCCCCCAAAAACCCCCCCCCT
TCCCCCCCCCAAAAACCCCCCCCCT
TCCCCCCCCCAAAAACCCCCCCCCT
TCCCCCCCCCAAAAACCCCCCCCCT
TCCCCCCCCCAAAAACCCCCCCCCT
TCCCCCCCCCAAAAACCCCCCCCCT
TCCCCCCCCCAAAAACCCCCCCCCT
TCCCCCCCCCAAAAACCCCCCCCCT
TCCCCCCCCCAAAAACCCCCCCCCT
TCCCCCCCCCAAAAACCCCCCCCCT
TCCCCCCCCCAAAAACCCCCCCCCT
TTTTTTCCCCCCCCCCCCCCTTTTT
TCCCCCCCCCCCCCCCCCCCCCCCT
TCCCCCCCCCTTTTTCCCCCCCCCT
TCCCCCCCCCCCCCCCCCCCCCCCT
TCCCCCCCCCCCCCCCCCCCCCCCT
TCCCCCCCCCCCCCCCCCCCCCCCT
TTTTTTTTTTTTTTTTTTTTTTTTT